**************
*           E*
* ********** *
*S        *  *
********* * **
        * * *
        *   *
        *****
