**********************************************
*S       *     *     *        *              *
****  *  *  *  *  *  *  ****  *  *  **********
*     *     *  *  *     *     *  *     *     *
*  *************  *******  ****  ****  *  *  *
*     *           *     *     *  *     *  *  *
*  *  ****  **********  *  *  ****  ****  *  *
*  *  *     *           *  *  *     *     *  *
*  *  *  *******  *  *******  *  ****  ****  *
*  *  *  *  *     *           *  *  *  *     *
*  *  *  *  *  ****  **********  *  *  *  ****
*  *  *  *     *     *     *     *     *  *  *
*  ****  ****  *  *******  *  *******  *  *  *
*     *  *     *     *        *     *  *     *
****  *  *  *******  *  *  ****  *  *  *******
*  *     *  *     *  *  *     *  *  *     *  *
*  *  ****  ****  *  *  *******  *  ****  *  *
*  *  *     *     *              *     *  *  *
*  ****  ****  *******************  ****  *  *
*  *        *     *                 *        *
*  *  *  *******  *  *******  *  ****  *  ****
*     *  *     *     *        *        *     *
**********  *  *  ****  *******************  *
*           *  *  *           *              *
*  **********  *  ****  ****  *  *************
*     *        *     *     *  *     *     *  *
*  *  *************  ****  *  ****  *  *  *  *
*  *        *  *     *     *     *  *  *  *  *
*  *******  *  *  ****  *******  *  *  *  *  *
*        *        *     *        *     *    E*  
**********************************************